NO ./path_to_the_north_texture
SO ./path_to_the_south_texture
WE ./path_to_the_west_texture             
EA ./path_to_the_east_texture                           
F 220,100,0
C 225,30,0
111111111111111
100010100000101
10N011000000011
100010000000101
110010000000101
100000111110111
100000000011001
111101111111111
111101111111111
110000001101011
111111111111111