NO ./textues/greystone.xpm
SO ./textues/redbrick.xpm
WE ./textues/bluestone.xpm             
EA ./textues/purplestone.xpm                           
C 192,192,192
F 153,204,255
11111111111111111
10000000000000001
10101010101010101
10100000000000101
10111111111111001
10000000000000001
11111010101111101
10000000000001001
10111011101001001
10001000000001001
11101111111111101
10000000000000001
111111111111111S1
10000000000000001
11111111111111111