NO ./path_to_the_north_texture
SO ./path_to_the_south_texture
WE ./path_to_the_west_texture             
EA ./path_to_the_east_texture                           
F 220,100,0
C 225,30,0
11111111111111111
1N000000000000001
10101010101010101
10100000000000101
10111111111111001
10000000000000001
11111010101111101
10000000000001001
10111011101001001
10001000000001001
11101111111111101
10000000000000001
11111111111111101
10000000000000001
11111111111111111