NO ./path_to_the_north_texture
SO ./path_to_the_south_texture
WE ./path_to_the_west_texture             
EA ./path_to_the_east_texture                           
F 220,100,0
C 225,30,0
111111111111111
1010100N0000101
101100010000011
101010100000101
110010010000101
100000101110111
100000000011001
111101111111111
111101111111111
110000001101011
111111111111111