NO ./textues/purplestone.png
SO ./textues/bluestone.png
WE ./textues/redbrick.png     
EA ./textues/greystone.png               
F 220,100,0
C 225,30,0
1111111111
1000000101
1000000001
1000000001
1000000001
1000000001
1000000001
1000000001
10000N0001
1111111111