NO ./textues/greystone.xpm
SO ./textues/redbrick.xpm
WE ./textues/bluestone.xpm             
EA ./textues/purplestone.xpm                           
C 192,192,192
F 153,204,255
11111111111111111
10000000000000001
10101010101010101
10000000000000001
10101010101010101
10000000000000001
10101010101010101
10000000000000001
10010101010101011
10000000000000001
10101010101010101
10000000000000001
111111111111111S1
10000000000000001
11111111111111111