NO ./textues/greystone.xpm
SO ./textues/redbrick.xpm
WE ./textues/bluestone.xpm             
EA ./textues/purplestone.xpm                           
C 192,192,192
F 153,204,255
1111111111111
110101001011
100000010001
100000010001
101010000001
111011110N0111
101111010001
111111111111